time - время
person - личность(персона)
year - год(календарный)
way - путь(дорога,тропа)
day - день
thing - вещь(штука, предмет)
man - мужчина/человек(зависит от контекста)
world - мир(значение место)
life - жизнь
hand - рука(до кисти)
palm - ладонь
part - часть(чего-то)
child - ребенок
eye - глаз
woman - женщина
place - место(местоположение)
work - работа
week - неделя
case - случай
point - точка(любая точка кроме адресной строки, в строке это dot)
government - правительство
company - компания
number - число
group - группа
problem - проблема(когда говорим о чем-то, что является причиной нашего беспокойства или трудностей)
fact - факт
home - дом
water - вода
room - комната
mother - мама
area - место(площадь)
money - деньги(любые)
story - история(не наука)
issue - проблема(когда говорим о предмете споров и обсуждений)
side - сторона
friend - друг
father - отец(папа)
power - сила(физическая величина,мощность)
hour - час
game - игра
line - линия
end - конец
member - участник(какой-либо организации)
law - закон
car - машина(авто)
city - город(большой)
community - сообщество
party - вечеринка
health - здоровье
school - школа
state - состояние

Прилагательные

good - хороший
new - новый(если только только выпустили то brand new)
first - первый 
last - последний	
long - длинный(также может иметь значение долго)
great - великий(великолепный и прочие синонимы)
little - маленький(не только про размер но про количество)
own - собственный
other - другой(остальной, дополнительный)
old - старый
right - правый(правильный)
big - большой
high - высокий
different - другой(отличный, не такой же)
small - маленький
large - огромный
next - следующий(да это причастие, но в английском их нет)
early - ранний
young - молодой
important - важный
few - несколько
public - публичный(общественный)
bad - плохой
same - похожий
able - способный(умеющий) 
possible - возможный
likely - вероятный(возможный)
social - социальный
clear - чистый
full - полный
special - специальный(уникальный)
easy - простой(легкий)
strong - сильный
simple - простой(легкий, используется в основном для показания сложности обучения и тд)
hard - тяжелый(трудный)
open - открытый
rich - богатый
beautiful - красивый
happy - веселый(счастливый)
sad - грустный(печальный)
serious - серьёзный
current - текущий(сейчас)
nice - приятный(классный)
fine - хороший
safe - безопасный
local - местный(региональный, локальный(не ну гений ))
major - главный(важный)
specific - специфичный(необычный)

Глаголы
be - быть
have - иметь
do - делать
say - говорить(фразу)
get - получать
make - делать(созидательный процесс , создавать)
go - идти
know -знать
take - брать
see - видеть
come - идти
think - думать
look - смотреть
want - хотеть
give - давать
use - использовать(предмет)
find - искать
tell - рассказывать
ask - спрашивать(задавать вопрос)
work - работать
seem - выглядеть
feel - чуствовать
try - пытаться(стараться, пробовать)
leave - покидать
call - звать
keep - продолжать
let - позволять
begin - начинать
help - помогать
show - показывать
hear - слышать
play - играть
run - бегать
move - двигаться
like - любить
live - жить
believe - верить
hold - держать
bring - держать
happen - происходить
write - писать
provide - предоставлять(обеспечивать)
sit - сидеть
stand - стоять
lose - проигрывать
pay - платить
meet - встречать
include - включать(в себя)
continue - продолжить
set - устанавливать(например время)
learn - учиться
change - менять
lead - вести за собой
understand - понимать
watch - смотреть
follow - следовать
stop - останавливать
create - созидать
speak - разговаривать(на языках)
read - читать
spend - тратить
grow - расти
open - открывать
walk - идти
win - побеждать
offer - предлагать
remember - помнить
love - любить
consider - рассматривать(как проблему)
appear - появляться
buy - покупать
wait - ждать
serve - обслуживать
die - умирать
send - отправлять
expect - ожидать(от чего-либо)
build - строить
stay - стоять
fall - падать
cut - резать(сокращать)
reach - достигать
kill - убивать
remain - оставаться 
suggest - предлагать(советовать)
raise - поднимать
pass - проходить
sell - продавать
require - требовать 
report - сообщать(о чем-то)
decide - решить(выбрать вариант действия)
pull - заполнить
return - возвращать(возвращаться)
explain - объяснять
hope - надеется(надежда, вера в лучше)
develop - разрабатывать(развитие)
carry - заботиться(нести)
break - ломать
receive - получать
agree - соглашаться
support - поддерживать